"filename", "language", "TypeScript", "HTML", "CSS", "SCSS", "comment", "blank", "total"
"c:\Users\U4708\Desktop\WFM\FE\ByMe\wfm-20220111\src\app\active-schedule\active-schedule-routing.module.ts", "TypeScript", 11, 0, 0, 0, 0, 3, 14
"c:\Users\U4708\Desktop\WFM\FE\ByMe\wfm-20220111\src\app\active-schedule\active-schedule.module.ts", "TypeScript", 44, 0, 0, 0, 0, 3, 47
"c:\Users\U4708\Desktop\WFM\FE\ByMe\wfm-20220111\src\app\active-schedule\generate\generate.component.css", "CSS", 0, 0, 16, 0, 0, 2, 18
"c:\Users\U4708\Desktop\WFM\FE\ByMe\wfm-20220111\src\app\active-schedule\generate\generate.component.html", "HTML", 0, 151, 0, 0, 0, 4, 155
"c:\Users\U4708\Desktop\WFM\FE\ByMe\wfm-20220111\src\app\active-schedule\generate\generate.component.spec.ts", "TypeScript", 20, 0, 0, 0, 0, 6, 26
"c:\Users\U4708\Desktop\WFM\FE\ByMe\wfm-20220111\src\app\active-schedule\generate\generate.component.ts", "TypeScript", 121, 0, 0, 0, 0, 10, 131
"c:\Users\U4708\Desktop\WFM\FE\ByMe\wfm-20220111\src\app\admin\ad-groups\ad-groups.component.css", "CSS", 0, 0, 0, 0, 0, 1, 1
"c:\Users\U4708\Desktop\WFM\FE\ByMe\wfm-20220111\src\app\admin\ad-groups\ad-groups.component.html", "HTML", 0, 59, 0, 0, 0, 1, 60
"c:\Users\U4708\Desktop\WFM\FE\ByMe\wfm-20220111\src\app\admin\ad-groups\ad-groups.component.spec.ts", "TypeScript", 20, 0, 0, 0, 0, 6, 26
"c:\Users\U4708\Desktop\WFM\FE\ByMe\wfm-20220111\src\app\admin\ad-groups\ad-groups.component.ts", "TypeScript", 32, 0, 0, 0, 0, 4, 36
"c:\Users\U4708\Desktop\WFM\FE\ByMe\wfm-20220111\src\app\admin\ad-users\ad-users.component.css", "CSS", 0, 0, 0, 0, 0, 1, 1
"c:\Users\U4708\Desktop\WFM\FE\ByMe\wfm-20220111\src\app\admin\ad-users\ad-users.component.html", "HTML", 0, 59, 0, 0, 0, 1, 60
"c:\Users\U4708\Desktop\WFM\FE\ByMe\wfm-20220111\src\app\admin\ad-users\ad-users.component.spec.ts", "TypeScript", 20, 0, 0, 0, 0, 6, 26
"c:\Users\U4708\Desktop\WFM\FE\ByMe\wfm-20220111\src\app\admin\ad-users\ad-users.component.ts", "TypeScript", 33, 0, 0, 0, 0, 3, 36
"c:\Users\U4708\Desktop\WFM\FE\ByMe\wfm-20220111\src\app\admin\admin-routing.module.ts", "TypeScript", 12, 0, 0, 0, 0, 3, 15
"c:\Users\U4708\Desktop\WFM\FE\ByMe\wfm-20220111\src\app\admin\admin.module.ts", "TypeScript", 45, 0, 0, 0, 0, 4, 49
"c:\Users\U4708\Desktop\WFM\FE\ByMe\wfm-20220111\src\app\admin\roles\roles.component.css", "CSS", 0, 0, 12, 0, 0, 1, 13
"c:\Users\U4708\Desktop\WFM\FE\ByMe\wfm-20220111\src\app\admin\roles\roles.component.html", "HTML", 0, 110, 0, 0, 0, 2, 112
"c:\Users\U4708\Desktop\WFM\FE\ByMe\wfm-20220111\src\app\admin\roles\roles.component.spec.ts", "TypeScript", 20, 0, 0, 0, 0, 6, 26
"c:\Users\U4708\Desktop\WFM\FE\ByMe\wfm-20220111\src\app\admin\roles\roles.component.ts", "TypeScript", 76, 0, 0, 0, 1, 6, 83
"c:\Users\U4708\Desktop\WFM\FE\ByMe\wfm-20220111\src\app\analysis\adherence-by-hos\adherence-by-hos.component.css", "CSS", 0, 0, 0, 0, 0, 1, 1
"c:\Users\U4708\Desktop\WFM\FE\ByMe\wfm-20220111\src\app\analysis\adherence-by-hos\adherence-by-hos.component.html", "HTML", 0, 6, 0, 0, 0, 1, 7
"c:\Users\U4708\Desktop\WFM\FE\ByMe\wfm-20220111\src\app\analysis\adherence-by-hos\adherence-by-hos.component.spec.ts", "TypeScript", 20, 0, 0, 0, 0, 6, 26
"c:\Users\U4708\Desktop\WFM\FE\ByMe\wfm-20220111\src\app\analysis\adherence-by-hos\adherence-by-hos.component.ts", "TypeScript", 22, 0, 0, 0, 0, 5, 27
"c:\Users\U4708\Desktop\WFM\FE\ByMe\wfm-20220111\src\app\analysis\analysis-routing.module.ts", "TypeScript", 11, 0, 0, 0, 0, 3, 14
"c:\Users\U4708\Desktop\WFM\FE\ByMe\wfm-20220111\src\app\analysis\analysis.module.ts", "TypeScript", 54, 0, 0, 0, 0, 4, 58
"c:\Users\U4708\Desktop\WFM\FE\ByMe\wfm-20220111\src\app\analysis\daily-report\daily-report.component.css", "CSS", 0, 0, 0, 0, 0, 3, 3
"c:\Users\U4708\Desktop\WFM\FE\ByMe\wfm-20220111\src\app\analysis\daily-report\daily-report.component.html", "HTML", 0, 40, 0, 0, 0, 2, 42
"c:\Users\U4708\Desktop\WFM\FE\ByMe\wfm-20220111\src\app\analysis\daily-report\daily-report.component.spec.ts", "TypeScript", 20, 0, 0, 0, 0, 6, 26
"c:\Users\U4708\Desktop\WFM\FE\ByMe\wfm-20220111\src\app\analysis\daily-report\daily-report.component.ts", "TypeScript", 62, 0, 0, 0, 0, 6, 68
"c:\Users\U4708\Desktop\WFM\FE\ByMe\wfm-20220111\src\app\analysis\leader-board\leader-board.component.css", "CSS", 0, 0, 0, 0, 0, 1, 1
"c:\Users\U4708\Desktop\WFM\FE\ByMe\wfm-20220111\src\app\analysis\leader-board\leader-board.component.html", "HTML", 0, 23, 0, 0, 0, 5, 28
"c:\Users\U4708\Desktop\WFM\FE\ByMe\wfm-20220111\src\app\analysis\leader-board\leader-board.component.spec.ts", "TypeScript", 20, 0, 0, 0, 0, 6, 26
"c:\Users\U4708\Desktop\WFM\FE\ByMe\wfm-20220111\src\app\analysis\leader-board\leader-board.component.ts", "TypeScript", 48, 0, 0, 0, 2, 4, 54
"c:\Users\U4708\Desktop\WFM\FE\ByMe\wfm-20220111\src\app\analysis\schedule-dashboard\schedule-dashboard.component.css", "CSS", 0, 0, 19, 0, 0, 4, 23
"c:\Users\U4708\Desktop\WFM\FE\ByMe\wfm-20220111\src\app\analysis\schedule-dashboard\schedule-dashboard.component.html", "HTML", 0, 55, 0, 0, 19, 2, 76
"c:\Users\U4708\Desktop\WFM\FE\ByMe\wfm-20220111\src\app\analysis\schedule-dashboard\schedule-dashboard.component.spec.ts", "TypeScript", 35, 0, 0, 0, 0, 6, 41
"c:\Users\U4708\Desktop\WFM\FE\ByMe\wfm-20220111\src\app\analysis\schedule-dashboard\schedule-dashboard.component.ts", "TypeScript", 41, 0, 0, 0, 1, 4, 46
"c:\Users\U4708\Desktop\WFM\FE\ByMe\wfm-20220111\src\app\app-directives\auto-focus.directive.spec.ts", "TypeScript", 7, 0, 0, 0, 0, 2, 9
"c:\Users\U4708\Desktop\WFM\FE\ByMe\wfm-20220111\src\app\app-directives\auto-focus.directive.ts", "TypeScript", 10, 0, 0, 0, 0, 4, 14
"c:\Users\U4708\Desktop\WFM\FE\ByMe\wfm-20220111\src\app\app-guards\auth.guard.spec.ts", "TypeScript", 12, 0, 0, 0, 0, 5, 17
"c:\Users\U4708\Desktop\WFM\FE\ByMe\wfm-20220111\src\app\app-guards\auth.guard.ts", "TypeScript", 26, 0, 0, 0, 0, 4, 30
"c:\Users\U4708\Desktop\WFM\FE\ByMe\wfm-20220111\src\app\app-helpers\date-helper.ts", "TypeScript", 24, 0, 0, 0, 6, 3, 33
"c:\Users\U4708\Desktop\WFM\FE\ByMe\wfm-20220111\src\app\app-interceptors\error.interceptor.spec.ts", "TypeScript", 13, 0, 0, 0, 0, 4, 17
"c:\Users\U4708\Desktop\WFM\FE\ByMe\wfm-20220111\src\app\app-interceptors\error.interceptor.ts", "TypeScript", 37, 0, 0, 0, 0, 4, 41
"c:\Users\U4708\Desktop\WFM\FE\ByMe\wfm-20220111\src\app\app-interceptors\negotiate.interceptor.spec.ts", "TypeScript", 13, 0, 0, 0, 0, 4, 17
"c:\Users\U4708\Desktop\WFM\FE\ByMe\wfm-20220111\src\app\app-interceptors\negotiate.interceptor.ts", "TypeScript", 16, 0, 0, 0, 0, 4, 20
"c:\Users\U4708\Desktop\WFM\FE\ByMe\wfm-20220111\src\app\app-interceptors\pretend.interceptor.spec.ts", "TypeScript", 13, 0, 0, 0, 0, 4, 17
"c:\Users\U4708\Desktop\WFM\FE\ByMe\wfm-20220111\src\app\app-interceptors\pretend.interceptor.ts", "TypeScript", 20, 0, 0, 0, 0, 4, 24
"c:\Users\U4708\Desktop\WFM\FE\ByMe\wfm-20220111\src\app\app-models\ShiftsAndActivities.ts", "TypeScript", 41, 0, 0, 0, 3, 4, 48
"c:\Users\U4708\Desktop\WFM\FE\ByMe\wfm-20220111\src\app\app-models\adherences.ts", "TypeScript", 32, 0, 0, 0, 0, 2, 34
"c:\Users\U4708\Desktop\WFM\FE\ByMe\wfm-20220111\src\app\app-models\analysis.ts", "TypeScript", 23, 0, 0, 0, 0, 1, 24
"c:\Users\U4708\Desktop\WFM\FE\ByMe\wfm-20220111\src\app\app-models\attendance-types.ts", "TypeScript", 14, 0, 0, 0, 0, 3, 17
"c:\Users\U4708\Desktop\WFM\FE\ByMe\wfm-20220111\src\app\app-models\day-offs.ts", "TypeScript", 71, 0, 0, 0, 0, 8, 79
"c:\Users\U4708\Desktop\WFM\FE\ByMe\wfm-20220111\src\app\app-models\forecasts.ts", "TypeScript", 67, 0, 0, 0, 0, 7, 74
"c:\Users\U4708\Desktop\WFM\FE\ByMe\wfm-20220111\src\app\app-models\resources.ts", "TypeScript", 97, 0, 0, 0, 0, 13, 110
"c:\Users\U4708\Desktop\WFM\FE\ByMe\wfm-20220111\src\app\app-models\root-models\app-user.ts", "TypeScript", 48, 0, 0, 0, 0, 2, 50
"c:\Users\U4708\Desktop\WFM\FE\ByMe\wfm-20220111\src\app\app-models\schedule-details.ts", "TypeScript", 313, 0, 0, 0, 1, 16, 330
"c:\Users\U4708\Desktop\WFM\FE\ByMe\wfm-20220111\src\app\app-models\schedules.ts", "TypeScript", 56, 0, 0, 0, 6, 9, 71
"c:\Users\U4708\Desktop\WFM\FE\ByMe\wfm-20220111\src\app\app-models\shared\app-config.ts", "TypeScript", 11, 0, 0, 0, 0, 1, 12
"c:\Users\U4708\Desktop\WFM\FE\ByMe\wfm-20220111\src\app\app-models\shared\dictionaries.ts", "TypeScript", 4, 0, 0, 0, 0, 1, 5
"c:\Users\U4708\Desktop\WFM\FE\ByMe\wfm-20220111\src\app\app-models\shared\nav-item.ts", "TypeScript", 8, 0, 0, 0, 0, 1, 9
"c:\Users\U4708\Desktop\WFM\FE\ByMe\wfm-20220111\src\app\app-models\shared\table-config.ts", "TypeScript", 37, 0, 0, 0, 0, 3, 40
"c:\Users\U4708\Desktop\WFM\FE\ByMe\wfm-20220111\src\app\app-models\swap-requests.ts", "TypeScript", 38, 0, 0, 0, 0, 4, 42
"c:\Users\U4708\Desktop\WFM\FE\ByMe\wfm-20220111\src\app\app-pipes\adherence.pipe.ts", "TypeScript", 32, 0, 0, 0, 0, 5, 37
"c:\Users\U4708\Desktop\WFM\FE\ByMe\wfm-20220111\src\app\app-pipes\adherenceloader.pipe.spec.ts", "TypeScript", 7, 0, 0, 0, 0, 2, 9
"c:\Users\U4708\Desktop\WFM\FE\ByMe\wfm-20220111\src\app\app-pipes\adherenceloader.pipe.ts", "TypeScript", 63, 0, 0, 0, 0, 4, 67
"c:\Users\U4708\Desktop\WFM\FE\ByMe\wfm-20220111\src\app\app-pipes\approved.pipe.spec.ts", "TypeScript", 7, 0, 0, 0, 0, 2, 9
"c:\Users\U4708\Desktop\WFM\FE\ByMe\wfm-20220111\src\app\app-pipes\approved.pipe.ts", "TypeScript", 14, 0, 0, 0, 0, 4, 18
"c:\Users\U4708\Desktop\WFM\FE\ByMe\wfm-20220111\src\app\app-pipes\dynamic.pipe.spec.ts", "TypeScript", 7, 0, 0, 0, 0, 2, 9
"c:\Users\U4708\Desktop\WFM\FE\ByMe\wfm-20220111\src\app\app-pipes\dynamic.pipe.ts", "TypeScript", 22, 0, 0, 0, 6, 3, 31
"c:\Users\U4708\Desktop\WFM\FE\ByMe\wfm-20220111\src\app\app-pipes\merge.pipe.spec.ts", "TypeScript", 7, 0, 0, 0, 0, 2, 9
"c:\Users\U4708\Desktop\WFM\FE\ByMe\wfm-20220111\src\app\app-pipes\merge.pipe.ts", "TypeScript", 12, 0, 0, 0, 0, 5, 17
"c:\Users\U4708\Desktop\WFM\FE\ByMe\wfm-20220111\src\app\app-pipes\useradherence.pipe.spec.ts", "TypeScript", 7, 0, 0, 0, 0, 2, 9
"c:\Users\U4708\Desktop\WFM\FE\ByMe\wfm-20220111\src\app\app-pipes\useradherence.pipe.ts", "TypeScript", 9, 0, 0, 0, 0, 4, 13
"c:\Users\U4708\Desktop\WFM\FE\ByMe\wfm-20220111\src\app\app-routing.module.ts", "TypeScript", 27, 0, 0, 0, 0, 3, 30
"c:\Users\U4708\Desktop\WFM\FE\ByMe\wfm-20220111\src\app\app-services\adherences\adherence.service.spec.ts", "TypeScript", 12, 0, 0, 0, 0, 5, 17
"c:\Users\U4708\Desktop\WFM\FE\ByMe\wfm-20220111\src\app\app-services\adherences\adherence.service.ts", "TypeScript", 412, 0, 0, 0, 6, 22, 440
"c:\Users\U4708\Desktop\WFM\FE\ByMe\wfm-20220111\src\app\app-services\analysis.service.spec.ts", "TypeScript", 12, 0, 0, 0, 0, 5, 17
"c:\Users\U4708\Desktop\WFM\FE\ByMe\wfm-20220111\src\app\app-services\analysis.service.ts", "TypeScript", 44, 0, 0, 0, 0, 3, 47
"c:\Users\U4708\Desktop\WFM\FE\ByMe\wfm-20220111\src\app\app-services\configurations\config.service.spec.ts", "TypeScript", 12, 0, 0, 0, 0, 5, 17
"c:\Users\U4708\Desktop\WFM\FE\ByMe\wfm-20220111\src\app\app-services\configurations\config.service.ts", "TypeScript", 64, 0, 0, 0, 0, 3, 67
"c:\Users\U4708\Desktop\WFM\FE\ByMe\wfm-20220111\src\app\app-services\day-offs\day-off.service.spec.ts", "TypeScript", 12, 0, 0, 0, 0, 5, 17
"c:\Users\U4708\Desktop\WFM\FE\ByMe\wfm-20220111\src\app\app-services\day-offs\day-off.service.ts", "TypeScript", 242, 0, 0, 0, 2, 6, 250
"c:\Users\U4708\Desktop\WFM\FE\ByMe\wfm-20220111\src\app\app-services\forecasts\forecast.service.ts", "TypeScript", 169, 0, 0, 0, 0, 6, 175
"c:\Users\U4708\Desktop\WFM\FE\ByMe\wfm-20220111\src\app\app-services\resources\head-of-section.service.spec.ts", "TypeScript", 12, 0, 0, 0, 0, 5, 17
"c:\Users\U4708\Desktop\WFM\FE\ByMe\wfm-20220111\src\app\app-services\resources\head-of-section.service.ts", "TypeScript", 148, 0, 0, 0, 0, 3, 151
"c:\Users\U4708\Desktop\WFM\FE\ByMe\wfm-20220111\src\app\app-services\resources\location.service.spec.ts", "TypeScript", 12, 0, 0, 0, 0, 5, 17
"c:\Users\U4708\Desktop\WFM\FE\ByMe\wfm-20220111\src\app\app-services\resources\location.service.ts", "TypeScript", 80, 0, 0, 0, 0, 3, 83
"c:\Users\U4708\Desktop\WFM\FE\ByMe\wfm-20220111\src\app\app-services\resources\staff-member.service.spec.ts", "TypeScript", 12, 0, 0, 0, 0, 5, 17
"c:\Users\U4708\Desktop\WFM\FE\ByMe\wfm-20220111\src\app\app-services\resources\staff-member.service.ts", "TypeScript", 170, 0, 0, 0, 0, 8, 178
"c:\Users\U4708\Desktop\WFM\FE\ByMe\wfm-20220111\src\app\app-services\resources\staff-type.service.spec.ts", "TypeScript", 12, 0, 0, 0, 0, 5, 17
"c:\Users\U4708\Desktop\WFM\FE\ByMe\wfm-20220111\src\app\app-services\resources\staff-type.service.ts", "TypeScript", 79, 0, 0, 0, 0, 4, 83
"c:\Users\U4708\Desktop\WFM\FE\ByMe\wfm-20220111\src\app\app-services\resources\transportation.service.spec.ts", "TypeScript", 12, 0, 0, 0, 0, 5, 17
"c:\Users\U4708\Desktop\WFM\FE\ByMe\wfm-20220111\src\app\app-services\resources\transportation.service.ts", "TypeScript", 84, 0, 0, 0, 0, 3, 87
"c:\Users\U4708\Desktop\WFM\FE\ByMe\wfm-20220111\src\app\app-services\root-services\initial.service.spec.ts", "TypeScript", 12, 0, 0, 0, 0, 5, 17
"c:\Users\U4708\Desktop\WFM\FE\ByMe\wfm-20220111\src\app\app-services\root-services\initial.service.ts", "TypeScript", 68, 0, 0, 0, 2, 6, 76
"c:\Users\U4708\Desktop\WFM\FE\ByMe\wfm-20220111\src\app\app-services\root-services\nav-item.service.spec.ts", "TypeScript", 12, 0, 0, 0, 0, 5, 17
"c:\Users\U4708\Desktop\WFM\FE\ByMe\wfm-20220111\src\app\app-services\root-services\nav-item.service.ts", "TypeScript", 59, 0, 0, 0, 0, 5, 64
"c:\Users\U4708\Desktop\WFM\FE\ByMe\wfm-20220111\src\app\app-services\schedule-details\schedule-detail.service.spec.ts", "TypeScript", 12, 0, 0, 0, 0, 5, 17
"c:\Users\U4708\Desktop\WFM\FE\ByMe\wfm-20220111\src\app\app-services\schedule-details\schedule-detail.service.ts", "TypeScript", 295, 0, 0, 0, 0, 7, 302
"c:\Users\U4708\Desktop\WFM\FE\ByMe\wfm-20220111\src\app\app-services\schedules\schedule.service.spec.ts", "TypeScript", 12, 0, 0, 0, 0, 5, 17
"c:\Users\U4708\Desktop\WFM\FE\ByMe\wfm-20220111\src\app\app-services\schedules\schedule.service.ts", "TypeScript", 264, 0, 0, 0, 0, 8, 272
"c:\Users\U4708\Desktop\WFM\FE\ByMe\wfm-20220111\src\app\app-services\shared\confirm.service.spec.ts", "TypeScript", 12, 0, 0, 0, 0, 5, 17
"c:\Users\U4708\Desktop\WFM\FE\ByMe\wfm-20220111\src\app\app-services\shared\confirm.service.ts", "TypeScript", 13, 0, 0, 0, 0, 3, 16
"c:\Users\U4708\Desktop\WFM\FE\ByMe\wfm-20220111\src\app\app-services\shared\error.service.spec.ts", "TypeScript", 12, 0, 0, 0, 0, 5, 17
"c:\Users\U4708\Desktop\WFM\FE\ByMe\wfm-20220111\src\app\app-services\shared\error.service.ts", "TypeScript", 12, 0, 0, 0, 0, 3, 15
"c:\Users\U4708\Desktop\WFM\FE\ByMe\wfm-20220111\src\app\app-services\shifts-and-activities\activity.service.spec.ts", "TypeScript", 12, 0, 0, 0, 0, 5, 17
"c:\Users\U4708\Desktop\WFM\FE\ByMe\wfm-20220111\src\app\app-services\shifts-and-activities\activity.service.ts", "TypeScript", 105, 0, 0, 0, 0, 6, 111
"c:\Users\U4708\Desktop\WFM\FE\ByMe\wfm-20220111\src\app\app-services\shifts-and-activities\attendance-type.service.spec.ts", "TypeScript", 12, 0, 0, 0, 0, 5, 17
"c:\Users\U4708\Desktop\WFM\FE\ByMe\wfm-20220111\src\app\app-services\shifts-and-activities\attendance-type.service.ts", "TypeScript", 82, 0, 0, 0, 0, 9, 91
"c:\Users\U4708\Desktop\WFM\FE\ByMe\wfm-20220111\src\app\app-services\shifts-and-activities\shift.service.spec.ts", "TypeScript", 12, 0, 0, 0, 0, 5, 17
"c:\Users\U4708\Desktop\WFM\FE\ByMe\wfm-20220111\src\app\app-services\shifts-and-activities\shift.service.ts", "TypeScript", 95, 0, 0, 0, 0, 6, 101
"c:\Users\U4708\Desktop\WFM\FE\ByMe\wfm-20220111\src\app\app-services\swap-requests\swap-request.service.spec.ts", "TypeScript", 12, 0, 0, 0, 0, 5, 17
"c:\Users\U4708\Desktop\WFM\FE\ByMe\wfm-20220111\src\app\app-services\swap-requests\swap-request.service.ts", "TypeScript", 137, 0, 0, 0, 0, 8, 145
"c:\Users\U4708\Desktop\WFM\FE\ByMe\wfm-20220111\src\app\app.component.css", "CSS", 0, 0, 0, 0, 0, 1, 1
"c:\Users\U4708\Desktop\WFM\FE\ByMe\wfm-20220111\src\app\app.component.html", "HTML", 0, 8, 0, 0, 0, 1, 9
"c:\Users\U4708\Desktop\WFM\FE\ByMe\wfm-20220111\src\app\app.component.spec.ts", "TypeScript", 31, 0, 0, 0, 0, 5, 36
"c:\Users\U4708\Desktop\WFM\FE\ByMe\wfm-20220111\src\app\app.component.ts", "TypeScript", 40, 0, 0, 0, 0, 5, 45
"c:\Users\U4708\Desktop\WFM\FE\ByMe\wfm-20220111\src\app\app.module.ts", "TypeScript", 66, 0, 0, 0, 0, 5, 71
"c:\Users\U4708\Desktop\WFM\FE\ByMe\wfm-20220111\src\app\charts\bar-chart\bar-chart.component.css", "CSS", 0, 0, 0, 0, 0, 1, 1
"c:\Users\U4708\Desktop\WFM\FE\ByMe\wfm-20220111\src\app\charts\bar-chart\bar-chart.component.html", "HTML", 0, 9, 0, 0, 0, 3, 12
"c:\Users\U4708\Desktop\WFM\FE\ByMe\wfm-20220111\src\app\charts\bar-chart\bar-chart.component.spec.ts", "TypeScript", 20, 0, 0, 0, 0, 6, 26
"c:\Users\U4708\Desktop\WFM\FE\ByMe\wfm-20220111\src\app\charts\bar-chart\bar-chart.component.ts", "TypeScript", 22, 0, 0, 0, 0, 2, 24
"c:\Users\U4708\Desktop\WFM\FE\ByMe\wfm-20220111\src\app\charts\chart.service.spec.ts", "TypeScript", 12, 0, 0, 0, 0, 5, 17
"c:\Users\U4708\Desktop\WFM\FE\ByMe\wfm-20220111\src\app\charts\chart.service.ts", "TypeScript", 25, 0, 0, 0, 0, 3, 28
"c:\Users\U4708\Desktop\WFM\FE\ByMe\wfm-20220111\src\app\charts\charts.module.ts", "TypeScript", 22, 0, 0, 0, 0, 4, 26
"c:\Users\U4708\Desktop\WFM\FE\ByMe\wfm-20220111\src\app\charts\line-chart\line-chart.component.css", "CSS", 0, 0, 0, 0, 0, 2, 2
"c:\Users\U4708\Desktop\WFM\FE\ByMe\wfm-20220111\src\app\charts\line-chart\line-chart.component.html", "HTML", 0, 9, 0, 0, 0, 3, 12
"c:\Users\U4708\Desktop\WFM\FE\ByMe\wfm-20220111\src\app\charts\line-chart\line-chart.component.spec.ts", "TypeScript", 20, 0, 0, 0, 0, 6, 26
"c:\Users\U4708\Desktop\WFM\FE\ByMe\wfm-20220111\src\app\charts\line-chart\line-chart.component.ts", "TypeScript", 23, 0, 0, 0, 0, 2, 25
"c:\Users\U4708\Desktop\WFM\FE\ByMe\wfm-20220111\src\app\day-offs\admin-approval-list\admin-approval-list.component.css", "CSS", 0, 0, 3, 0, 0, 1, 4
"c:\Users\U4708\Desktop\WFM\FE\ByMe\wfm-20220111\src\app\day-offs\admin-approval-list\admin-approval-list.component.html", "HTML", 0, 55, 0, 0, 0, 4, 59
"c:\Users\U4708\Desktop\WFM\FE\ByMe\wfm-20220111\src\app\day-offs\admin-approval-list\admin-approval-list.component.spec.ts", "TypeScript", 20, 0, 0, 0, 0, 6, 26
"c:\Users\U4708\Desktop\WFM\FE\ByMe\wfm-20220111\src\app\day-offs\admin-approval-list\admin-approval-list.component.ts", "TypeScript", 55, 0, 0, 0, 1, 7, 63
"c:\Users\U4708\Desktop\WFM\FE\ByMe\wfm-20220111\src\app\day-offs\admin-approved\admin-approved.component.css", "CSS", 0, 0, 19, 0, 10, 3, 32
"c:\Users\U4708\Desktop\WFM\FE\ByMe\wfm-20220111\src\app\day-offs\admin-approved\admin-approved.component.html", "HTML", 0, 115, 0, 0, 0, 1, 116
"c:\Users\U4708\Desktop\WFM\FE\ByMe\wfm-20220111\src\app\day-offs\admin-approved\admin-approved.component.spec.ts", "TypeScript", 20, 0, 0, 0, 0, 6, 26
"c:\Users\U4708\Desktop\WFM\FE\ByMe\wfm-20220111\src\app\day-offs\admin-approved\admin-approved.component.ts", "TypeScript", 96, 0, 0, 0, 0, 5, 101
"c:\Users\U4708\Desktop\WFM\FE\ByMe\wfm-20220111\src\app\day-offs\admin-need-approval\admin-need-approval.component.css", "CSS", 0, 0, 19, 0, 10, 4, 33
"c:\Users\U4708\Desktop\WFM\FE\ByMe\wfm-20220111\src\app\day-offs\admin-need-approval\admin-need-approval.component.html", "HTML", 0, 114, 0, 0, 0, 1, 115
"c:\Users\U4708\Desktop\WFM\FE\ByMe\wfm-20220111\src\app\day-offs\admin-need-approval\admin-need-approval.component.spec.ts", "TypeScript", 20, 0, 0, 0, 0, 6, 26
"c:\Users\U4708\Desktop\WFM\FE\ByMe\wfm-20220111\src\app\day-offs\admin-need-approval\admin-need-approval.component.ts", "TypeScript", 95, 0, 0, 0, 0, 5, 100
"c:\Users\U4708\Desktop\WFM\FE\ByMe\wfm-20220111\src\app\day-offs\approved-summary\approved-summary.component.css", "CSS", 0, 0, 0, 0, 0, 1, 1
"c:\Users\U4708\Desktop\WFM\FE\ByMe\wfm-20220111\src\app\day-offs\approved-summary\approved-summary.component.html", "HTML", 0, 37, 0, 0, 0, 3, 40
"c:\Users\U4708\Desktop\WFM\FE\ByMe\wfm-20220111\src\app\day-offs\approved-summary\approved-summary.component.spec.ts", "TypeScript", 20, 0, 0, 0, 0, 6, 26
"c:\Users\U4708\Desktop\WFM\FE\ByMe\wfm-20220111\src\app\day-offs\approved-summary\approved-summary.component.ts", "TypeScript", 35, 0, 0, 0, 0, 5, 40
"c:\Users\U4708\Desktop\WFM\FE\ByMe\wfm-20220111\src\app\day-offs\day-offs-routing.module.ts", "TypeScript", 16, 0, 0, 0, 0, 3, 19
"c:\Users\U4708\Desktop\WFM\FE\ByMe\wfm-20220111\src\app\day-offs\day-offs.module.ts", "TypeScript", 64, 0, 0, 0, 0, 4, 68
"c:\Users\U4708\Desktop\WFM\FE\ByMe\wfm-20220111\src\app\day-offs\upload\upload.component.html", "HTML", 0, 74, 0, 0, 1, 6, 81
"c:\Users\U4708\Desktop\WFM\FE\ByMe\wfm-20220111\src\app\day-offs\upload\upload.component.scss", "SCSS", 0, 0, 0, 142, 2, 19, 163
"c:\Users\U4708\Desktop\WFM\FE\ByMe\wfm-20220111\src\app\day-offs\upload\upload.component.spec.ts", "TypeScript", 20, 0, 0, 0, 0, 6, 26
"c:\Users\U4708\Desktop\WFM\FE\ByMe\wfm-20220111\src\app\day-offs\upload\upload.component.ts", "TypeScript", 80, 0, 0, 0, 0, 9, 89
"c:\Users\U4708\Desktop\WFM\FE\ByMe\wfm-20220111\src\app\day-offs\user-choice\user-choice.component.css", "CSS", 0, 0, 6, 0, 0, 1, 7
"c:\Users\U4708\Desktop\WFM\FE\ByMe\wfm-20220111\src\app\day-offs\user-choice\user-choice.component.html", "HTML", 0, 106, 0, 0, 0, 2, 108
"c:\Users\U4708\Desktop\WFM\FE\ByMe\wfm-20220111\src\app\day-offs\user-choice\user-choice.component.spec.ts", "TypeScript", 20, 0, 0, 0, 0, 6, 26
"c:\Users\U4708\Desktop\WFM\FE\ByMe\wfm-20220111\src\app\day-offs\user-choice\user-choice.component.ts", "TypeScript", 42, 0, 0, 0, 0, 4, 46
"c:\Users\U4708\Desktop\WFM\FE\ByMe\wfm-20220111\src\app\forecasts\forecast-add\forecast-add.component.css", "CSS", 0, 0, 7, 0, 0, 2, 9
"c:\Users\U4708\Desktop\WFM\FE\ByMe\wfm-20220111\src\app\forecasts\forecast-add\forecast-add.component.html", "HTML", 0, 112, 0, 0, 5, 3, 120
"c:\Users\U4708\Desktop\WFM\FE\ByMe\wfm-20220111\src\app\forecasts\forecast-add\forecast-add.component.spec.ts", "TypeScript", 20, 0, 0, 0, 0, 6, 26
"c:\Users\U4708\Desktop\WFM\FE\ByMe\wfm-20220111\src\app\forecasts\forecast-add\forecast-add.component.ts", "TypeScript", 89, 0, 0, 0, 0, 7, 96
"c:\Users\U4708\Desktop\WFM\FE\ByMe\wfm-20220111\src\app\forecasts\forecast-details\forecast-details.component.css", "CSS", 0, 0, 16, 0, 0, 2, 18
"c:\Users\U4708\Desktop\WFM\FE\ByMe\wfm-20220111\src\app\forecasts\forecast-details\forecast-details.component.html", "HTML", 0, 44, 0, 0, 0, 2, 46
"c:\Users\U4708\Desktop\WFM\FE\ByMe\wfm-20220111\src\app\forecasts\forecast-details\forecast-details.component.spec.ts", "TypeScript", 20, 0, 0, 0, 0, 6, 26
"c:\Users\U4708\Desktop\WFM\FE\ByMe\wfm-20220111\src\app\forecasts\forecast-details\forecast-details.component.ts", "TypeScript", 44, 0, 0, 0, 0, 5, 49
"c:\Users\U4708\Desktop\WFM\FE\ByMe\wfm-20220111\src\app\forecasts\forecast-list\forecast-list.component.css", "CSS", 0, 0, 0, 0, 0, 1, 1
"c:\Users\U4708\Desktop\WFM\FE\ByMe\wfm-20220111\src\app\forecasts\forecast-list\forecast-list.component.html", "HTML", 0, 88, 0, 0, 8, 4, 100
"c:\Users\U4708\Desktop\WFM\FE\ByMe\wfm-20220111\src\app\forecasts\forecast-list\forecast-list.component.spec.ts", "TypeScript", 20, 0, 0, 0, 0, 6, 26
"c:\Users\U4708\Desktop\WFM\FE\ByMe\wfm-20220111\src\app\forecasts\forecast-list\forecast-list.component.ts", "TypeScript", 46, 0, 0, 0, 0, 4, 50
"c:\Users\U4708\Desktop\WFM\FE\ByMe\wfm-20220111\src\app\forecasts\forecasts-routing.module.ts", "TypeScript", 14, 0, 0, 0, 0, 3, 17
"c:\Users\U4708\Desktop\WFM\FE\ByMe\wfm-20220111\src\app\forecasts\forecasts.module.ts", "TypeScript", 54, 0, 0, 0, 0, 3, 57
"c:\Users\U4708\Desktop\WFM\FE\ByMe\wfm-20220111\src\app\home\home.component.css", "CSS", 0, 0, 17, 0, 0, 2, 19
"c:\Users\U4708\Desktop\WFM\FE\ByMe\wfm-20220111\src\app\home\home.component.html", "HTML", 0, 62, 0, 0, 0, 3, 65
"c:\Users\U4708\Desktop\WFM\FE\ByMe\wfm-20220111\src\app\home\home.component.spec.ts", "TypeScript", 20, 0, 0, 0, 0, 6, 26
"c:\Users\U4708\Desktop\WFM\FE\ByMe\wfm-20220111\src\app\home\home.component.ts", "TypeScript", 15, 0, 0, 0, 0, 4, 19
"c:\Users\U4708\Desktop\WFM\FE\ByMe\wfm-20220111\src\app\main-nav\main-nav.component.css", "CSS", 0, 0, 7, 0, 0, 2, 9
"c:\Users\U4708\Desktop\WFM\FE\ByMe\wfm-20220111\src\app\main-nav\main-nav.component.html", "HTML", 0, 55, 0, 0, 0, 2, 57
"c:\Users\U4708\Desktop\WFM\FE\ByMe\wfm-20220111\src\app\main-nav\main-nav.component.spec.ts", "TypeScript", 20, 0, 0, 0, 0, 6, 26
"c:\Users\U4708\Desktop\WFM\FE\ByMe\wfm-20220111\src\app\main-nav\main-nav.component.ts", "TypeScript", 21, 0, 0, 0, 0, 4, 25
"c:\Users\U4708\Desktop\WFM\FE\ByMe\wfm-20220111\src\app\not-found\not-found.component.css", "CSS", 0, 0, 0, 0, 0, 1, 1
"c:\Users\U4708\Desktop\WFM\FE\ByMe\wfm-20220111\src\app\not-found\not-found.component.html", "HTML", 0, 8, 0, 0, 0, 1, 9
"c:\Users\U4708\Desktop\WFM\FE\ByMe\wfm-20220111\src\app\not-found\not-found.component.spec.ts", "TypeScript", 20, 0, 0, 0, 0, 6, 26
"c:\Users\U4708\Desktop\WFM\FE\ByMe\wfm-20220111\src\app\not-found\not-found.component.ts", "TypeScript", 11, 0, 0, 0, 0, 5, 16
"c:\Users\U4708\Desktop\WFM\FE\ByMe\wfm-20220111\src\app\resources\head-of-section-add\head-of-section-add.component.css", "CSS", 0, 0, 0, 0, 0, 1, 1
"c:\Users\U4708\Desktop\WFM\FE\ByMe\wfm-20220111\src\app\resources\head-of-section-add\head-of-section-add.component.html", "HTML", 0, 68, 0, 0, 0, 1, 69
"c:\Users\U4708\Desktop\WFM\FE\ByMe\wfm-20220111\src\app\resources\head-of-section-add\head-of-section-add.component.spec.ts", "TypeScript", 20, 0, 0, 0, 0, 6, 26
"c:\Users\U4708\Desktop\WFM\FE\ByMe\wfm-20220111\src\app\resources\head-of-section-add\head-of-section-add.component.ts", "TypeScript", 35, 0, 0, 0, 0, 4, 39
"c:\Users\U4708\Desktop\WFM\FE\ByMe\wfm-20220111\src\app\resources\head-of-section-list\head-of-section-list.component.css", "CSS", 0, 0, 0, 0, 0, 1, 1
"c:\Users\U4708\Desktop\WFM\FE\ByMe\wfm-20220111\src\app\resources\head-of-section-list\head-of-section-list.component.html", "HTML", 0, 22, 0, 0, 0, 4, 26
"c:\Users\U4708\Desktop\WFM\FE\ByMe\wfm-20220111\src\app\resources\head-of-section-list\head-of-section-list.component.spec.ts", "TypeScript", 20, 0, 0, 0, 0, 6, 26
"c:\Users\U4708\Desktop\WFM\FE\ByMe\wfm-20220111\src\app\resources\head-of-section-list\head-of-section-list.component.ts", "TypeScript", 32, 0, 0, 0, 0, 4, 36
"c:\Users\U4708\Desktop\WFM\FE\ByMe\wfm-20220111\src\app\resources\location-add\location-add.component.css", "CSS", 0, 0, 0, 0, 0, 1, 1
"c:\Users\U4708\Desktop\WFM\FE\ByMe\wfm-20220111\src\app\resources\location-add\location-add.component.html", "HTML", 0, 27, 0, 0, 0, 1, 28
"c:\Users\U4708\Desktop\WFM\FE\ByMe\wfm-20220111\src\app\resources\location-add\location-add.component.spec.ts", "TypeScript", 20, 0, 0, 0, 0, 6, 26
"c:\Users\U4708\Desktop\WFM\FE\ByMe\wfm-20220111\src\app\resources\location-add\location-add.component.ts", "TypeScript", 27, 0, 0, 0, 0, 4, 31
"c:\Users\U4708\Desktop\WFM\FE\ByMe\wfm-20220111\src\app\resources\location-list\location-list.component.css", "CSS", 0, 0, 0, 0, 0, 1, 1
"c:\Users\U4708\Desktop\WFM\FE\ByMe\wfm-20220111\src\app\resources\location-list\location-list.component.html", "HTML", 0, 22, 0, 0, 0, 4, 26
"c:\Users\U4708\Desktop\WFM\FE\ByMe\wfm-20220111\src\app\resources\location-list\location-list.component.spec.ts", "TypeScript", 20, 0, 0, 0, 0, 6, 26
"c:\Users\U4708\Desktop\WFM\FE\ByMe\wfm-20220111\src\app\resources\location-list\location-list.component.ts", "TypeScript", 37, 0, 0, 0, 0, 4, 41
"c:\Users\U4708\Desktop\WFM\FE\ByMe\wfm-20220111\src\app\resources\resources-routing.module.ts", "TypeScript", 23, 0, 0, 0, 0, 3, 26
"c:\Users\U4708\Desktop\WFM\FE\ByMe\wfm-20220111\src\app\resources\resources.module.ts", "TypeScript", 63, 0, 0, 0, 0, 3, 66
"c:\Users\U4708\Desktop\WFM\FE\ByMe\wfm-20220111\src\app\resources\staff-member-add\staff-member-add.component.css", "CSS", 0, 0, 0, 0, 0, 1, 1
"c:\Users\U4708\Desktop\WFM\FE\ByMe\wfm-20220111\src\app\resources\staff-member-add\staff-member-add.component.html", "HTML", 0, 222, 0, 0, 0, 1, 223
"c:\Users\U4708\Desktop\WFM\FE\ByMe\wfm-20220111\src\app\resources\staff-member-add\staff-member-add.component.spec.ts", "TypeScript", 20, 0, 0, 0, 0, 6, 26
"c:\Users\U4708\Desktop\WFM\FE\ByMe\wfm-20220111\src\app\resources\staff-member-add\staff-member-add.component.ts", "TypeScript", 71, 0, 0, 0, 0, 6, 77
"c:\Users\U4708\Desktop\WFM\FE\ByMe\wfm-20220111\src\app\resources\staff-members-list\staff-members-list.component.css", "CSS", 0, 0, 0, 0, 0, 1, 1
"c:\Users\U4708\Desktop\WFM\FE\ByMe\wfm-20220111\src\app\resources\staff-members-list\staff-members-list.component.html", "HTML", 0, 27, 0, 0, 0, 2, 29
"c:\Users\U4708\Desktop\WFM\FE\ByMe\wfm-20220111\src\app\resources\staff-members-list\staff-members-list.component.spec.ts", "TypeScript", 20, 0, 0, 0, 0, 6, 26
"c:\Users\U4708\Desktop\WFM\FE\ByMe\wfm-20220111\src\app\resources\staff-members-list\staff-members-list.component.ts", "TypeScript", 39, 0, 0, 0, 1, 5, 45
"c:\Users\U4708\Desktop\WFM\FE\ByMe\wfm-20220111\src\app\resources\staff-type-add\staff-type-add.component.css", "CSS", 0, 0, 0, 0, 0, 1, 1
"c:\Users\U4708\Desktop\WFM\FE\ByMe\wfm-20220111\src\app\resources\staff-type-add\staff-type-add.component.html", "HTML", 0, 24, 0, 0, 0, 2, 26
"c:\Users\U4708\Desktop\WFM\FE\ByMe\wfm-20220111\src\app\resources\staff-type-add\staff-type-add.component.spec.ts", "TypeScript", 20, 0, 0, 0, 0, 6, 26
"c:\Users\U4708\Desktop\WFM\FE\ByMe\wfm-20220111\src\app\resources\staff-type-add\staff-type-add.component.ts", "TypeScript", 26, 0, 0, 0, 0, 4, 30
"c:\Users\U4708\Desktop\WFM\FE\ByMe\wfm-20220111\src\app\resources\staff-type-list\staff-type-list.component.css", "CSS", 0, 0, 0, 0, 0, 1, 1
"c:\Users\U4708\Desktop\WFM\FE\ByMe\wfm-20220111\src\app\resources\staff-type-list\staff-type-list.component.html", "HTML", 0, 22, 0, 0, 0, 4, 26
"c:\Users\U4708\Desktop\WFM\FE\ByMe\wfm-20220111\src\app\resources\staff-type-list\staff-type-list.component.spec.ts", "TypeScript", 20, 0, 0, 0, 0, 6, 26
"c:\Users\U4708\Desktop\WFM\FE\ByMe\wfm-20220111\src\app\resources\staff-type-list\staff-type-list.component.ts", "TypeScript", 37, 0, 0, 0, 0, 4, 41
"c:\Users\U4708\Desktop\WFM\FE\ByMe\wfm-20220111\src\app\resources\transportation-add\transportation-add.component.css", "CSS", 0, 0, 0, 0, 0, 1, 1
"c:\Users\U4708\Desktop\WFM\FE\ByMe\wfm-20220111\src\app\resources\transportation-add\transportation-add.component.html", "HTML", 0, 54, 0, 0, 0, 1, 55
"c:\Users\U4708\Desktop\WFM\FE\ByMe\wfm-20220111\src\app\resources\transportation-add\transportation-add.component.spec.ts", "TypeScript", 20, 0, 0, 0, 0, 6, 26
"c:\Users\U4708\Desktop\WFM\FE\ByMe\wfm-20220111\src\app\resources\transportation-add\transportation-add.component.ts", "TypeScript", 31, 0, 0, 0, 0, 5, 36
"c:\Users\U4708\Desktop\WFM\FE\ByMe\wfm-20220111\src\app\resources\transportation-list\transportation-list.component.css", "CSS", 0, 0, 0, 0, 0, 1, 1
"c:\Users\U4708\Desktop\WFM\FE\ByMe\wfm-20220111\src\app\resources\transportation-list\transportation-list.component.html", "HTML", 0, 22, 0, 0, 0, 4, 26
"c:\Users\U4708\Desktop\WFM\FE\ByMe\wfm-20220111\src\app\resources\transportation-list\transportation-list.component.spec.ts", "TypeScript", 20, 0, 0, 0, 0, 6, 26
"c:\Users\U4708\Desktop\WFM\FE\ByMe\wfm-20220111\src\app\resources\transportation-list\transportation-list.component.ts", "TypeScript", 37, 0, 0, 0, 0, 4, 41
"c:\Users\U4708\Desktop\WFM\FE\ByMe\wfm-20220111\src\app\schedule-details\attendance-history\attendance-history.component.css", "CSS", 0, 0, 0, 0, 0, 1, 1
"c:\Users\U4708\Desktop\WFM\FE\ByMe\wfm-20220111\src\app\schedule-details\attendance-history\attendance-history.component.html", "HTML", 0, 57, 0, 0, 0, 1, 58
"c:\Users\U4708\Desktop\WFM\FE\ByMe\wfm-20220111\src\app\schedule-details\attendance-history\attendance-history.component.spec.ts", "TypeScript", 20, 0, 0, 0, 0, 6, 26
"c:\Users\U4708\Desktop\WFM\FE\ByMe\wfm-20220111\src\app\schedule-details\attendance-history\attendance-history.component.ts", "TypeScript", 48, 0, 0, 0, 0, 5, 53
"c:\Users\U4708\Desktop\WFM\FE\ByMe\wfm-20220111\src\app\schedule-details\daily-attendance\daily-attendance.component.css", "CSS", 0, 0, 0, 0, 0, 2, 2
"c:\Users\U4708\Desktop\WFM\FE\ByMe\wfm-20220111\src\app\schedule-details\daily-attendance\daily-attendance.component.html", "HTML", 0, 130, 0, 0, 0, 4, 134
"c:\Users\U4708\Desktop\WFM\FE\ByMe\wfm-20220111\src\app\schedule-details\daily-attendance\daily-attendance.component.spec.ts", "TypeScript", 20, 0, 0, 0, 0, 6, 26
"c:\Users\U4708\Desktop\WFM\FE\ByMe\wfm-20220111\src\app\schedule-details\daily-attendance\daily-attendance.component.ts", "TypeScript", 161, 0, 0, 0, 19, 12, 192
"c:\Users\U4708\Desktop\WFM\FE\ByMe\wfm-20220111\src\app\schedule-details\schedule-by-date\schedule-by-date.component.css", "CSS", 0, 0, 0, 0, 0, 1, 1
"c:\Users\U4708\Desktop\WFM\FE\ByMe\wfm-20220111\src\app\schedule-details\schedule-by-date\schedule-by-date.component.html", "HTML", 0, 112, 0, 0, 4, 1, 117
"c:\Users\U4708\Desktop\WFM\FE\ByMe\wfm-20220111\src\app\schedule-details\schedule-by-date\schedule-by-date.component.spec.ts", "TypeScript", 20, 0, 0, 0, 0, 6, 26
"c:\Users\U4708\Desktop\WFM\FE\ByMe\wfm-20220111\src\app\schedule-details\schedule-by-date\schedule-by-date.component.ts", "TypeScript", 166, 0, 0, 0, 3, 8, 177
"c:\Users\U4708\Desktop\WFM\FE\ByMe\wfm-20220111\src\app\schedule-details\schedule-by-staff-date\schedule-by-staff-date.component.css", "CSS", 0, 0, 17, 0, 0, 5, 22
"c:\Users\U4708\Desktop\WFM\FE\ByMe\wfm-20220111\src\app\schedule-details\schedule-by-staff-date\schedule-by-staff-date.component.html", "HTML", 0, 35, 0, 0, 0, 1, 36
"c:\Users\U4708\Desktop\WFM\FE\ByMe\wfm-20220111\src\app\schedule-details\schedule-by-staff-date\schedule-by-staff-date.component.spec.ts", "TypeScript", 20, 0, 0, 0, 0, 6, 26
"c:\Users\U4708\Desktop\WFM\FE\ByMe\wfm-20220111\src\app\schedule-details\schedule-by-staff-date\schedule-by-staff-date.component.ts", "TypeScript", 76, 0, 0, 0, 0, 2, 78
"c:\Users\U4708\Desktop\WFM\FE\ByMe\wfm-20220111\src\app\schedule-details\schedule-by-staff\schedule-by-staff.component.css", "CSS", 0, 0, 17, 0, 0, 4, 21
"c:\Users\U4708\Desktop\WFM\FE\ByMe\wfm-20220111\src\app\schedule-details\schedule-by-staff\schedule-by-staff.component.html", "HTML", 0, 22, 0, 0, 0, 3, 25
"c:\Users\U4708\Desktop\WFM\FE\ByMe\wfm-20220111\src\app\schedule-details\schedule-by-staff\schedule-by-staff.component.spec.ts", "TypeScript", 20, 0, 0, 0, 0, 6, 26
"c:\Users\U4708\Desktop\WFM\FE\ByMe\wfm-20220111\src\app\schedule-details\schedule-by-staff\schedule-by-staff.component.ts", "TypeScript", 45, 0, 0, 0, 0, 6, 51
"c:\Users\U4708\Desktop\WFM\FE\ByMe\wfm-20220111\src\app\schedule-details\schedule-details-routing.module.ts", "TypeScript", 21, 0, 0, 0, 0, 3, 24
"c:\Users\U4708\Desktop\WFM\FE\ByMe\wfm-20220111\src\app\schedule-details\schedule-details.module.ts", "TypeScript", 76, 0, 0, 0, 0, 3, 79
"c:\Users\U4708\Desktop\WFM\FE\ByMe\wfm-20220111\src\app\schedule-details\shared-elements\interval-box\interval-box.component.css", "CSS", 0, 0, 0, 0, 0, 1, 1
"c:\Users\U4708\Desktop\WFM\FE\ByMe\wfm-20220111\src\app\schedule-details\shared-elements\interval-box\interval-box.component.html", "HTML", 0, 9, 0, 0, 0, 1, 10
"c:\Users\U4708\Desktop\WFM\FE\ByMe\wfm-20220111\src\app\schedule-details\shared-elements\interval-box\interval-box.component.spec.ts", "TypeScript", 20, 0, 0, 0, 0, 6, 26
"c:\Users\U4708\Desktop\WFM\FE\ByMe\wfm-20220111\src\app\schedule-details\shared-elements\interval-box\interval-box.component.ts", "TypeScript", 24, 0, 0, 0, 0, 5, 29
"c:\Users\U4708\Desktop\WFM\FE\ByMe\wfm-20220111\src\app\schedule-details\shared-elements\schedule-details-table\schedule-details-table.component.css", "CSS", 0, 0, 0, 0, 0, 1, 1
"c:\Users\U4708\Desktop\WFM\FE\ByMe\wfm-20220111\src\app\schedule-details\shared-elements\schedule-details-table\schedule-details-table.component.html", "HTML", 0, 68, 0, 0, 0, 2, 70
"c:\Users\U4708\Desktop\WFM\FE\ByMe\wfm-20220111\src\app\schedule-details\shared-elements\schedule-details-table\schedule-details-table.component.spec.ts", "TypeScript", 20, 0, 0, 0, 0, 6, 26
"c:\Users\U4708\Desktop\WFM\FE\ByMe\wfm-20220111\src\app\schedule-details\shared-elements\schedule-details-table\schedule-details-table.component.ts", "TypeScript", 131, 0, 0, 0, 0, 7, 138
"c:\Users\U4708\Desktop\WFM\FE\ByMe\wfm-20220111\src\app\schedule-details\shared-elements\schedule-manipulation.service.spec.ts", "TypeScript", 12, 0, 0, 0, 0, 5, 17
"c:\Users\U4708\Desktop\WFM\FE\ByMe\wfm-20220111\src\app\schedule-details\shared-elements\schedule-manipulation.service.ts", "TypeScript", 72, 0, 0, 0, 27, 8, 107
"c:\Users\U4708\Desktop\WFM\FE\ByMe\wfm-20220111\src\app\schedule-details\shared-elements\search-autocomplete\search-autocomplete.component.css", "CSS", 0, 0, 0, 0, 0, 1, 1
"c:\Users\U4708\Desktop\WFM\FE\ByMe\wfm-20220111\src\app\schedule-details\shared-elements\search-autocomplete\search-autocomplete.component.html", "HTML", 0, 27, 0, 0, 0, 1, 28
"c:\Users\U4708\Desktop\WFM\FE\ByMe\wfm-20220111\src\app\schedule-details\shared-elements\search-autocomplete\search-autocomplete.component.spec.ts", "TypeScript", 20, 0, 0, 0, 0, 6, 26
"c:\Users\U4708\Desktop\WFM\FE\ByMe\wfm-20220111\src\app\schedule-details\shared-elements\search-autocomplete\search-autocomplete.component.ts", "TypeScript", 63, 0, 0, 0, 0, 5, 68
"c:\Users\U4708\Desktop\WFM\FE\ByMe\wfm-20220111\src\app\schedule-details\shared-elements\selectable-menu\selectable-menu.component.css", "CSS", 0, 0, 0, 0, 0, 1, 1
"c:\Users\U4708\Desktop\WFM\FE\ByMe\wfm-20220111\src\app\schedule-details\shared-elements\selectable-menu\selectable-menu.component.html", "HTML", 0, 9, 0, 0, 0, 2, 11
"c:\Users\U4708\Desktop\WFM\FE\ByMe\wfm-20220111\src\app\schedule-details\shared-elements\selectable-menu\selectable-menu.component.spec.ts", "TypeScript", 20, 0, 0, 0, 0, 6, 26
"c:\Users\U4708\Desktop\WFM\FE\ByMe\wfm-20220111\src\app\schedule-details\shared-elements\selectable-menu\selectable-menu.component.ts", "TypeScript", 32, 0, 0, 0, 0, 4, 36
"c:\Users\U4708\Desktop\WFM\FE\ByMe\wfm-20220111\src\app\schedules\schedule-add\schedule-add.component.css", "CSS", 0, 0, 3, 0, 0, 1, 4
"c:\Users\U4708\Desktop\WFM\FE\ByMe\wfm-20220111\src\app\schedules\schedule-add\schedule-add.component.html", "HTML", 0, 76, 0, 0, 0, 1, 77
"c:\Users\U4708\Desktop\WFM\FE\ByMe\wfm-20220111\src\app\schedules\schedule-add\schedule-add.component.spec.ts", "TypeScript", 20, 0, 0, 0, 0, 6, 26
"c:\Users\U4708\Desktop\WFM\FE\ByMe\wfm-20220111\src\app\schedules\schedule-add\schedule-add.component.ts", "TypeScript", 46, 0, 0, 0, 2, 7, 55
"c:\Users\U4708\Desktop\WFM\FE\ByMe\wfm-20220111\src\app\schedules\schedule-list-hos-user\schedule-list-hos-user.component.css", "CSS", 0, 0, 0, 0, 0, 1, 1
"c:\Users\U4708\Desktop\WFM\FE\ByMe\wfm-20220111\src\app\schedules\schedule-list-hos-user\schedule-list-hos-user.component.html", "HTML", 0, 47, 0, 0, 0, 3, 50
"c:\Users\U4708\Desktop\WFM\FE\ByMe\wfm-20220111\src\app\schedules\schedule-list-hos-user\schedule-list-hos-user.component.spec.ts", "TypeScript", 20, 0, 0, 0, 0, 6, 26
"c:\Users\U4708\Desktop\WFM\FE\ByMe\wfm-20220111\src\app\schedules\schedule-list-hos-user\schedule-list-hos-user.component.ts", "TypeScript", 25, 0, 0, 0, 0, 4, 29
"c:\Users\U4708\Desktop\WFM\FE\ByMe\wfm-20220111\src\app\schedules\schedule-list\schedule-list.component.css", "CSS", 0, 0, 0, 0, 0, 1, 1
"c:\Users\U4708\Desktop\WFM\FE\ByMe\wfm-20220111\src\app\schedules\schedule-list\schedule-list.component.html", "HTML", 0, 76, 0, 0, 8, 5, 89
"c:\Users\U4708\Desktop\WFM\FE\ByMe\wfm-20220111\src\app\schedules\schedule-list\schedule-list.component.spec.ts", "TypeScript", 20, 0, 0, 0, 0, 6, 26
"c:\Users\U4708\Desktop\WFM\FE\ByMe\wfm-20220111\src\app\schedules\schedule-list\schedule-list.component.ts", "TypeScript", 65, 0, 0, 0, 0, 5, 70
"c:\Users\U4708\Desktop\WFM\FE\ByMe\wfm-20220111\src\app\schedules\schedules-routing.module.ts", "TypeScript", 14, 0, 0, 0, 0, 3, 17
"c:\Users\U4708\Desktop\WFM\FE\ByMe\wfm-20220111\src\app\schedules\schedules.module.ts", "TypeScript", 51, 0, 0, 0, 0, 3, 54
"c:\Users\U4708\Desktop\WFM\FE\ByMe\wfm-20220111\src\app\shared\confirm\confirm.component.css", "CSS", 0, 0, 0, 0, 0, 1, 1
"c:\Users\U4708\Desktop\WFM\FE\ByMe\wfm-20220111\src\app\shared\confirm\confirm.component.html", "HTML", 0, 14, 0, 0, 0, 1, 15
"c:\Users\U4708\Desktop\WFM\FE\ByMe\wfm-20220111\src\app\shared\confirm\confirm.component.spec.ts", "TypeScript", 20, 0, 0, 0, 0, 6, 26
"c:\Users\U4708\Desktop\WFM\FE\ByMe\wfm-20220111\src\app\shared\confirm\confirm.component.ts", "TypeScript", 12, 0, 0, 0, 0, 5, 17
"c:\Users\U4708\Desktop\WFM\FE\ByMe\wfm-20220111\src\app\shared\data-table\data-table.component.css", "CSS", 0, 0, 29, 0, 0, 3, 32
"c:\Users\U4708\Desktop\WFM\FE\ByMe\wfm-20220111\src\app\shared\data-table\data-table.component.html", "HTML", 0, 35, 0, 0, 0, 2, 37
"c:\Users\U4708\Desktop\WFM\FE\ByMe\wfm-20220111\src\app\shared\data-table\data-table.component.spec.ts", "TypeScript", 20, 0, 0, 0, 0, 6, 26
"c:\Users\U4708\Desktop\WFM\FE\ByMe\wfm-20220111\src\app\shared\data-table\data-table.component.ts", "TypeScript", 86, 0, 0, 0, 0, 7, 93
"c:\Users\U4708\Desktop\WFM\FE\ByMe\wfm-20220111\src\app\shared\error\error.component.css", "CSS", 0, 0, 0, 0, 0, 1, 1
"c:\Users\U4708\Desktop\WFM\FE\ByMe\wfm-20220111\src\app\shared\error\error.component.html", "HTML", 0, 13, 0, 0, 0, 1, 14
"c:\Users\U4708\Desktop\WFM\FE\ByMe\wfm-20220111\src\app\shared\error\error.component.spec.ts", "TypeScript", 20, 0, 0, 0, 0, 6, 26
"c:\Users\U4708\Desktop\WFM\FE\ByMe\wfm-20220111\src\app\shared\error\error.component.ts", "TypeScript", 12, 0, 0, 0, 0, 5, 17
"c:\Users\U4708\Desktop\WFM\FE\ByMe\wfm-20220111\src\app\shared\input\input.component.css", "CSS", 0, 0, 0, 0, 0, 2, 2
"c:\Users\U4708\Desktop\WFM\FE\ByMe\wfm-20220111\src\app\shared\input\input.component.html", "HTML", 0, 11, 0, 0, 0, 1, 12
"c:\Users\U4708\Desktop\WFM\FE\ByMe\wfm-20220111\src\app\shared\input\input.component.spec.ts", "TypeScript", 20, 0, 0, 0, 0, 6, 26
"c:\Users\U4708\Desktop\WFM\FE\ByMe\wfm-20220111\src\app\shared\input\input.component.ts", "TypeScript", 44, 0, 0, 0, 0, 5, 49
"c:\Users\U4708\Desktop\WFM\FE\ByMe\wfm-20220111\src\app\shared\selector-card\selector-card.component.html", "HTML", 0, 20, 0, 0, 0, 1, 21
"c:\Users\U4708\Desktop\WFM\FE\ByMe\wfm-20220111\src\app\shared\selector-card\selector-card.component.scss", "SCSS", 0, 0, 0, 36, 0, 2, 38
"c:\Users\U4708\Desktop\WFM\FE\ByMe\wfm-20220111\src\app\shared\selector-card\selector-card.component.spec.ts", "TypeScript", 20, 0, 0, 0, 0, 6, 26
"c:\Users\U4708\Desktop\WFM\FE\ByMe\wfm-20220111\src\app\shared\selector-card\selector-card.component.ts", "TypeScript", 34, 0, 0, 0, 1, 3, 38
"c:\Users\U4708\Desktop\WFM\FE\ByMe\wfm-20220111\src\app\shared\shared.module.ts", "TypeScript", 54, 0, 0, 0, 0, 2, 56
"c:\Users\U4708\Desktop\WFM\FE\ByMe\wfm-20220111\src\app\shifts-and-activities\activity-add\activity-add.component.css", "CSS", 0, 0, 0, 0, 0, 1, 1
"c:\Users\U4708\Desktop\WFM\FE\ByMe\wfm-20220111\src\app\shifts-and-activities\activity-add\activity-add.component.html", "HTML", 0, 46, 0, 0, 0, 1, 47
"c:\Users\U4708\Desktop\WFM\FE\ByMe\wfm-20220111\src\app\shifts-and-activities\activity-add\activity-add.component.spec.ts", "TypeScript", 20, 0, 0, 0, 0, 6, 26
"c:\Users\U4708\Desktop\WFM\FE\ByMe\wfm-20220111\src\app\shifts-and-activities\activity-add\activity-add.component.ts", "TypeScript", 27, 0, 0, 0, 0, 4, 31
"c:\Users\U4708\Desktop\WFM\FE\ByMe\wfm-20220111\src\app\shifts-and-activities\activity-list\activity-list.component.css", "CSS", 0, 0, 0, 0, 0, 1, 1
"c:\Users\U4708\Desktop\WFM\FE\ByMe\wfm-20220111\src\app\shifts-and-activities\activity-list\activity-list.component.html", "HTML", 0, 22, 0, 0, 0, 4, 26
"c:\Users\U4708\Desktop\WFM\FE\ByMe\wfm-20220111\src\app\shifts-and-activities\activity-list\activity-list.component.spec.ts", "TypeScript", 20, 0, 0, 0, 0, 6, 26
"c:\Users\U4708\Desktop\WFM\FE\ByMe\wfm-20220111\src\app\shifts-and-activities\activity-list\activity-list.component.ts", "TypeScript", 32, 0, 0, 0, 0, 4, 36
"c:\Users\U4708\Desktop\WFM\FE\ByMe\wfm-20220111\src\app\shifts-and-activities\attendance-type-add\attendance-type-add.component.css", "CSS", 0, 0, 0, 0, 0, 1, 1
"c:\Users\U4708\Desktop\WFM\FE\ByMe\wfm-20220111\src\app\shifts-and-activities\attendance-type-add\attendance-type-add.component.html", "HTML", 0, 45, 0, 0, 0, 1, 46
"c:\Users\U4708\Desktop\WFM\FE\ByMe\wfm-20220111\src\app\shifts-and-activities\attendance-type-add\attendance-type-add.component.spec.ts", "TypeScript", 20, 0, 0, 0, 0, 6, 26
"c:\Users\U4708\Desktop\WFM\FE\ByMe\wfm-20220111\src\app\shifts-and-activities\attendance-type-add\attendance-type-add.component.ts", "TypeScript", 29, 0, 0, 0, 0, 4, 33
"c:\Users\U4708\Desktop\WFM\FE\ByMe\wfm-20220111\src\app\shifts-and-activities\attendance-type-list\attendance-type-list.component.css", "CSS", 0, 0, 0, 0, 0, 1, 1
"c:\Users\U4708\Desktop\WFM\FE\ByMe\wfm-20220111\src\app\shifts-and-activities\attendance-type-list\attendance-type-list.component.html", "HTML", 0, 22, 0, 0, 0, 4, 26
"c:\Users\U4708\Desktop\WFM\FE\ByMe\wfm-20220111\src\app\shifts-and-activities\attendance-type-list\attendance-type-list.component.spec.ts", "TypeScript", 20, 0, 0, 0, 0, 6, 26
"c:\Users\U4708\Desktop\WFM\FE\ByMe\wfm-20220111\src\app\shifts-and-activities\attendance-type-list\attendance-type-list.component.ts", "TypeScript", 32, 0, 0, 0, 0, 5, 37
"c:\Users\U4708\Desktop\WFM\FE\ByMe\wfm-20220111\src\app\shifts-and-activities\shift-add\shift-add.component.css", "CSS", 0, 0, 0, 0, 0, 1, 1
"c:\Users\U4708\Desktop\WFM\FE\ByMe\wfm-20220111\src\app\shifts-and-activities\shift-add\shift-add.component.html", "HTML", 0, 39, 0, 0, 0, 1, 40
"c:\Users\U4708\Desktop\WFM\FE\ByMe\wfm-20220111\src\app\shifts-and-activities\shift-add\shift-add.component.spec.ts", "TypeScript", 20, 0, 0, 0, 0, 6, 26
"c:\Users\U4708\Desktop\WFM\FE\ByMe\wfm-20220111\src\app\shifts-and-activities\shift-add\shift-add.component.ts", "TypeScript", 25, 0, 0, 0, 0, 4, 29
"c:\Users\U4708\Desktop\WFM\FE\ByMe\wfm-20220111\src\app\shifts-and-activities\shift-list\shift-list.component.css", "CSS", 0, 0, 0, 0, 0, 1, 1
"c:\Users\U4708\Desktop\WFM\FE\ByMe\wfm-20220111\src\app\shifts-and-activities\shift-list\shift-list.component.html", "HTML", 0, 22, 0, 0, 0, 4, 26
"c:\Users\U4708\Desktop\WFM\FE\ByMe\wfm-20220111\src\app\shifts-and-activities\shift-list\shift-list.component.spec.ts", "TypeScript", 20, 0, 0, 0, 0, 6, 26
"c:\Users\U4708\Desktop\WFM\FE\ByMe\wfm-20220111\src\app\shifts-and-activities\shift-list\shift-list.component.ts", "TypeScript", 33, 0, 0, 0, 0, 5, 38
"c:\Users\U4708\Desktop\WFM\FE\ByMe\wfm-20220111\src\app\shifts-and-activities\shifts-and-activities-routing.module.ts", "TypeScript", 15, 0, 0, 0, 0, 3, 18
"c:\Users\U4708\Desktop\WFM\FE\ByMe\wfm-20220111\src\app\shifts-and-activities\shifts-and-activities.module.ts", "TypeScript", 45, 0, 0, 0, 0, 4, 49
"c:\Users\U4708\Desktop\WFM\FE\ByMe\wfm-20220111\src\app\swap-requests\swap-request-add\swap-request-add.component.css", "CSS", 0, 0, 6, 0, 0, 1, 7
"c:\Users\U4708\Desktop\WFM\FE\ByMe\wfm-20220111\src\app\swap-requests\swap-request-add\swap-request-add.component.html", "HTML", 0, 85, 0, 0, 0, 1, 86
"c:\Users\U4708\Desktop\WFM\FE\ByMe\wfm-20220111\src\app\swap-requests\swap-request-add\swap-request-add.component.spec.ts", "TypeScript", 20, 0, 0, 0, 0, 6, 26
"c:\Users\U4708\Desktop\WFM\FE\ByMe\wfm-20220111\src\app\swap-requests\swap-request-add\swap-request-add.component.ts", "TypeScript", 62, 0, 0, 0, 0, 8, 70
"c:\Users\U4708\Desktop\WFM\FE\ByMe\wfm-20220111\src\app\swap-requests\swap-request-details\swap-request-details.component.css", "CSS", 0, 0, 0, 0, 0, 1, 1
"c:\Users\U4708\Desktop\WFM\FE\ByMe\wfm-20220111\src\app\swap-requests\swap-request-details\swap-request-details.component.html", "HTML", 0, 44, 0, 0, 0, 1, 45
"c:\Users\U4708\Desktop\WFM\FE\ByMe\wfm-20220111\src\app\swap-requests\swap-request-details\swap-request-details.component.spec.ts", "TypeScript", 20, 0, 0, 0, 0, 6, 26
"c:\Users\U4708\Desktop\WFM\FE\ByMe\wfm-20220111\src\app\swap-requests\swap-request-details\swap-request-details.component.ts", "TypeScript", 26, 0, 0, 0, 0, 6, 32
"c:\Users\U4708\Desktop\WFM\FE\ByMe\wfm-20220111\src\app\swap-requests\swap-request-list\swap-request-list.component.css", "CSS", 0, 0, 0, 0, 0, 1, 1
"c:\Users\U4708\Desktop\WFM\FE\ByMe\wfm-20220111\src\app\swap-requests\swap-request-list\swap-request-list.component.html", "HTML", 0, 20, 0, 0, 0, 5, 25
"c:\Users\U4708\Desktop\WFM\FE\ByMe\wfm-20220111\src\app\swap-requests\swap-request-list\swap-request-list.component.spec.ts", "TypeScript", 20, 0, 0, 0, 0, 6, 26
"c:\Users\U4708\Desktop\WFM\FE\ByMe\wfm-20220111\src\app\swap-requests\swap-request-list\swap-request-list.component.ts", "TypeScript", 32, 0, 0, 0, 0, 4, 36
"c:\Users\U4708\Desktop\WFM\FE\ByMe\wfm-20220111\src\app\swap-requests\swap-requests-routing.module.ts", "TypeScript", 13, 0, 0, 0, 0, 3, 16
"c:\Users\U4708\Desktop\WFM\FE\ByMe\wfm-20220111\src\app\swap-requests\swap-requests.module.ts", "TypeScript", 40, 0, 0, 0, 0, 4, 44
"c:\Users\U4708\Desktop\WFM\FE\ByMe\wfm-20220111\src\app\unauthorized\unauthorized.component.css", "CSS", 0, 0, 0, 0, 0, 1, 1
"c:\Users\U4708\Desktop\WFM\FE\ByMe\wfm-20220111\src\app\unauthorized\unauthorized.component.html", "HTML", 0, 8, 0, 0, 0, 1, 9
"c:\Users\U4708\Desktop\WFM\FE\ByMe\wfm-20220111\src\app\unauthorized\unauthorized.component.spec.ts", "TypeScript", 20, 0, 0, 0, 0, 6, 26
"c:\Users\U4708\Desktop\WFM\FE\ByMe\wfm-20220111\src\app\unauthorized\unauthorized.component.ts", "TypeScript", 11, 0, 0, 0, 0, 5, 16
"c:\Users\U4708\Desktop\WFM\FE\ByMe\wfm-20220111\src\custom-theme.scss", "SCSS", 0, 0, 0, 555, 45, 51, 651
"c:\Users\U4708\Desktop\WFM\FE\ByMe\wfm-20220111\src\environments\environment.prod.ts", "TypeScript", 4, 0, 0, 0, 3, 1, 8
"c:\Users\U4708\Desktop\WFM\FE\ByMe\wfm-20220111\src\environments\environment.ts", "TypeScript", 4, 0, 0, 0, 12, 3, 19
"c:\Users\U4708\Desktop\WFM\FE\ByMe\wfm-20220111\src\index.html", "HTML", 0, 13, 0, 0, 5, 1, 19
"c:\Users\U4708\Desktop\WFM\FE\ByMe\wfm-20220111\src\main.ts", "TypeScript", 9, 0, 0, 0, 0, 4, 13
"c:\Users\U4708\Desktop\WFM\FE\ByMe\wfm-20220111\src\polyfills.ts", "TypeScript", 1, 0, 0, 0, 47, 6, 54
"c:\Users\U4708\Desktop\WFM\FE\ByMe\wfm-20220111\src\styles.css", "CSS", 0, 0, 7, 0, 1, 1, 9
"c:\Users\U4708\Desktop\WFM\FE\ByMe\wfm-20220111\src\test.ts", "TypeScript", 18, 0, 0, 0, 4, 5, 27
"Total", "-", 9226, 3036, 220, 733, 274, 1444, 14933